You wake up from your nap and slowly get out of bed. You look around your room and out of the corner of your eye you see the time. You are 10 minutes late for the mission launch! You scramble to get dressed and get going.

Fighter Pilot 
An Interactive Fiction by Jalen Toyama
Release 1 / Serial number 190304 / Inform 7 build 6M62 (I6/v6.33 lib 6/12N) SD

Living quarters
A somewhat small room with a bed and a dresser. Nothing too fancy, but good enough to live in. The exit to the Hallway is to the south.

You can see Task list here.

>e
You can't go that way.

>e
You can't go that way.

>s
Hallway

>s
Mess hall

>e
Hanger
You can see Jackson here.

>talk to jackson
"Sir!" you say in a loud clear voice. 

"Yes corpral?" he replies sternly.

"Sir, do you have the equipment room key by any chance?" you ask

"As a matter of fact I do corpral. Do you need it for something? He asks 

"Yes sir!" you reply "I need to get my flight gear sir."

"Flight gear?" he questions "what do you need that for corpral?"

"For the mission sir." you reply faintly 

"Did i hear you say mission corpral?" he replies. 

"Yes Sir!" you answer

 "as far as i know there are no upcoming missions. unless you are talking about the mission that went under way 10 minutes ago! he yells"

"Yes sir, that one sir" you respond

"well why didnt you just ask for the key? he questions. you decide that it would be best to stop the conversation at this point.

* * *

You wake up from your nap and slowly get out of bed. You look around your room and out of the corner of your eye you see the time. You are 10 minutes late for the mission launch! You scramble to get dressed and get going.

Fighter Pilot 
An Interactive Fiction by Jalen Toyama
Release 1 / Serial number 190304 / Inform 7 build 6M62 (I6/v6.33 lib 6/12N) SD

Living quarters
A somewhat small room with a bed and a dresser. Nothing too fancy, but good enough to live in. The exit to the Hallway is to the south.

You can see Task list here.

>i
You are carrying nothing.

>x task list
The messy writing reads: Dont forget! get clean, get dressed and GO!

>x bed
The bed that was assigned to you. Not the most comfortable but better than nothing.

>x dresser
You can't see any such thing.

>s
Hallway
A hallway with many different paths and doors. The floor is a shining white synthetic polymer. Your living quarters are to the north. The Mess hall entrance is to the south. The Wash room is to the west and the equipment room is to the east.

>w
Wash room
The public wash room, much like the majority of the ship, fairly simple. There are rows of showers and lockers for storage of toiletries. One of the showers has been left slightly on.

You can see a shower here.

>x lockers
You can't see any such thing.

>use shower
That's not a verb I recognise.

>take shower
You turn on the shower and let it run for a bit to warm up. Once it is warm you jump in and take a quick shower to clean yourself up. You turn off the shower and dry off.

>e
Hallway
A hallway with many different paths and doors. The floor is a shining white synthetic polymer. Your living quarters are to the north. The Mess hall entrance is to the south. The Wash room is to the west and the equipment room is to the east.

>e
Equipment room
A cramped storage room with two lockers, one is taller than the other. The hallway is to the west.

>open locker
Which do you mean, Locker #1 or Locker #2?

>open locker 1
Which do you mean, Locker #1 or Locker #2?

>open locker #1
It seems to be locked.

>open locker #2
It seems to be locked.

>w
Hallway
A hallway with many different paths and doors. The floor is a shining white synthetic polymer. Your living quarters are to the north. The Mess hall entrance is to the south. The Wash room is to the west and the equipment room is to the east.

>n
Living quarters
A somewhat small room with a bed and a dresser. Nothing too fancy, but good enough to live in. The exit to the Hallway is to the south.

You can see Task list here.

>open dresser
You can't see any such thing.

>s
Hallway
A hallway with many different paths and doors. The floor is a shining white synthetic polymer. Your living quarters are to the north. The Mess hall entrance is to the south. The Wash room is to the west and the equipment room is to the east.

>s
Mess hall
The main mess hall of the ship. All of the workers seem to be off duty and as a result the whole place seems to be deserted. Not a single scrap of food is in sight. The hanger is to the east.

>e
Hanger
One of the smaller hangers in the ship. The floor is littered with empty storage containers and fuel cells. There are 8 seperate areas each assigned to one fighter. All but one of them is empty. The Mess hall entrance is to the west.

You can see Jackson here.

>x floor
You can't see any such thing.

>talk to jackson
"Sir!" you say in a loud clear voice. 

"Yes corpral?" he replies sternly.

"Sir, do you have the equipment room key by any chance?" you ask

"As a matter of fact I do corpral. Do you need it for something? He asks 

"Yes sir!" you reply "I need to get my flight gear sir."

"Flight gear?" he questions "what do you need that for corpral?"

"For the mission sir." you reply faintly 

"Did i hear you say mission corpral?" he replies. 

"Yes Sir!" you answer

 "as far as i know there are no upcoming missions. unless you are talking about the mission that went under way 10 minutes ago! he yells"

"Yes sir, that one sir" you respond

"well why didnt you just ask for the key? he questions.

 you decide that it would be best to stop the conversation at this point.

>i
You are carrying nothing.

>ask for the key
You can't see any such thing.

>ask jackson for key
"Sir may I have the equipment room key?" you ask 

 "Alright, here you go corpral." he replies

>i
You are carrying:
  an Equipment room key

>w
Mess hall
The main mess hall of the ship. All of the workers seem to be off duty and as a result the whole place seems to be deserted. Not a single scrap of food is in sight. The hanger is to the east.

>w
You can't go that way.

>n
Hallway
A hallway with many different paths and doors. The floor is a shining white synthetic polymer. Your living quarters are to the north. The Mess hall entrance is to the south. The Wash room is to the west and the equipment room is to the east.

>e
Equipment room
A cramped storage room with two lockers, one is taller than the other. The hallway is to the west.

>unlock locker #1 with key
You unlock Locker #1.

>open locker #1
You open Locker #1, revealing your pilot helmet.

>put pilot helmet on
(first taking your pilot helmet)
You put on your pilot helmet.

>unlock locker #2
What do you want to unlock Locker #2 with?

>unlock locker #2 with key
You unlock Locker #2.

>open locker #2
You open Locker #2, revealing your flight suit.

>put flight suit on
(first taking your flight suit)
You put on your flight suit.

    *** Now that you are in full combat uniform you head to your ship. You climb into the cockpit and strap yourself in. With the green light from mission controll you start the launch sequence. 3, 2, 1. At 1 the ship launches forward and you are compressed to the back of your seat. You quickly move to catch up to the rest of your squad. ***

Would you like to RESTART, RESTORE a saved game, QUIT or UNDO the last command?

* * *

You wake up from your nap and slowly get out of bed. You look around your room and out of the corner of your eye you see the time. You are 10 minutes late for the mission launch! You scramble to get dressed and get going.

Fighter Pilot 
An Interactive Fiction by Jalen Toyama
Release 1 / Serial number 190304 / Inform 7 build 6M62 (I6/v6.33 lib 6/12N) SD

Living quarters
A somewhat small room with a bed and a dresser. Nothing too fancy, but good enough to live in. The exit to the Hallway is to the south.

You can see Task list here.

>open dresser
Why would you do that? there are only clothes in there.

* * *

You wake up from your nap and slowly get out of bed. You look around your room and out of the corner of your eye you see the time. You are 10 minutes late for the mission launch! You scramble to get dressed and get going.

Fighter Pilot 
An Interactive Fiction by Jalen Toyama
Release 1 / Serial number 190304 / Inform 7 build 6M62 (I6/v6.33 lib 6/12N) SD

Living quarters
A somewhat small room with a bed and a dresser. Nothing too fancy, but good enough to live in. The exit to the Hallway is to the south.

You can see Task list here.

>s
Hallway
A hallway with many different paths and doors. The floor is a shining white synthetic polymer. Your living quarters are to the north. The Mess hall entrance is to the south. The Wash room is to the west and the equipment room is to the east.

>e
Equipment room
A cramped storage room with two lockers, one is taller than the other. The hallway is to the west.

>e
You can't go that way.

>w
Hallway

>w
Wash room

>w
You can't go that way.

>e
Hallway

>s
You can't go that way.

* * *

>e
Equipment room
A cramped storage room with two lockers, one is taller than the other. The hallway is to the west.

>open locker #1
It isn't something you can open.

>take suit
Taken.

>take helmet
Taken.

>put on suit
You can't wear that!

* * *

>e
Equipment room
A cramped storage room with two lockers, one is taller than the other. The hallway is to the west.

>take shower
You can't see any such thing.

* * *

>e
Equipment room
A cramped storage room with two lockers, one is taller than the other. The hallway is to the west.

>w
Hallway
A hallway with many different paths and doors. The floor is a shining white synthetic polymer. Your living quarters are to the north. The Mess hall is to the south. The Wash room is to the west and the equipment room is to the east.

>w
Wash room
The public wash room, much like the majority of the ship, fairly simple. There are rows of showers and lockers for storage of toiletries. One of the showers has been left on.

You can see a shower here.

>take a shower
You turn on the shower and let it run for a bit to warm up. Once it is warm you jump in and take a quick shower to clean yourself up.

* * *

>e
Equipment room
A cramped storage room with two lockers, one is taller than the other. The hallway is to the west.

>x room
You can't see any such thing.

>x locekr
You can't see any such thing.

>x Locker #1
A standard issue equipment locker standing at 6 feet tall. There is a worn down pinup poster on the front.

>open locker #1
It seems to be locked.

>unlock locker #1
What do you want to unlock Locker #1 with?

* * *

>s
Hallway
A hallway with many different paths and doors. The floor is a shining white synthetic polymer. Your living quarters are to the north. The Mess hall entrance is to the south. The Wash room is to the west and the equipment room is to the east.

>n
Living quarters

>s
Hallway

>n
Living quarters

* * *

>s
Hallway
A hallway with many different paths and doors. The floor is a shining white synthetic polymer. Your living quarters are to the north. The Mess hall entrance is to the south. The Wash room is to the west and the equipment room is to the east.

>s
Mess hall
The main mess hall of the ship. All of the workers seem to be off duty and as a result the whole place seems to be deserted. Not a single scrap of food is in sight. The hanger is to the east and the hallway is to the north.

>e
Hanger
One of the smaller hangers in the ship. The floor is littered with empty storage containers and fuel cells. There are 8 seperate areas each assigned to one fighter. All but one of them is empty. The Mess hall entrance is to the west.

You can see Jackson here.

>Talk to jackson
"Sir!" you say in a loud clear voice. 

"Yes corpral?" he replies sternly.

"Sir, do you have the equipment room key by any chance?" you ask

"As a matter of fact I do corpral. Do you need it for something? He asks 

"Yes sir!" you reply "I need to get my flight gear sir."

"Flight gear?" he questions "what do you need that for corpral?"

"For the mission sir." you reply faintly 

"Did i hear you say mission corpral?" he replies. 

"Yes Sir!" you answer

" "as far as i know there are no upcoming missions. unless you are talking about the mission that went under way 10 minutes ago! he yells

* * *

>e
Hanger
One of the smaller hangers in the ship. The floor is littered with empty storage containers and fuel cells. There are 8 seperate areas each assigned to one fighter. All but one of them is empty. The Mess hall entrance is to the west.

You can see Jackson here.

>X Jackson
Jackson, your squad leader, he is fully dressed in his combat uniform and seems to be ready for the mission.

>kiss jackson
Jackson might not like that.

>take combat suit
I only understood you as far as wanting to take the combat uniform.

>take combat uniform
That seems to belong to Jackson.

>Talk to Jackson
That's not a verb I recognise.

* * *

>e
Hanger
One of the smaller hangers in the ship. The floor is littered with empty storage containers and fuel cells. There are 8 seperate areas each assigned to one fighter. All but one of them is empty. The Mess hall entrance is to the west.

You can see Jackson here.

>ask about key
You can't see any such thing.

>ask jackson about key
"Sir may I have the equipment room key?" you ask 

 "Alright, here you go corpral." he replies

>w
Mess hall

>n
Hallway

>e
Equipment room

>unlock locker #1
(with the Equipment room key)
You unlock Locker #1.

>unlock locker #2
(with the Equipment room key)
You unlock Locker #2.

>open locker #1
You open Locker #1, revealing your pilot helmet.

>take
(your pilot helmet)
Taken.

>open locker #2
You open Locker #2, revealing your flight suit.

>take
(your flight suit)
Taken.

>put on helmet
You put on your pilot helmet.

>put on flight suit
You put on your flight suit.

>x helmet
Your pilot helmet, it was custom shaped to fit your head perfectly. It shares the same black and silver color scheme as your flight suit.

>x flight suit \
I only understood you as far as wanting to examine your flight suit.

>x flight suit
A skin tight silver suit with a black reinforced chest piece. Standard issue to all pilots in the military.

* * *

>e
Hanger
One of the smaller hangers in the ship. The floor is littered with empty storage containers and fuel cells. There are 8 seperate areas each assigned to one fighter. All but one of them is empty. The Mess hall entrance is to the west.

You can see Jackson here.

>ask jackson about equipment room key
"Sir may I have the equipment room key?" you ask 

 "Alright, here you go corpral." he replies

>w
Mess hall
The main mess hall of the ship. All of the workers seem to be off duty and as a result the whole place seems to be deserted. Not a single scrap of food is in sight. The hanger is to the east.

>n
Hallway
A hallway with many different paths and doors. The floor is a shining white synthetic polymer. Your living quarters are to the north. The Mess hall entrance is to the south. The Wash room is to the west and the equipment room is to the east.

>w
Wash room
The public wash room, much like the majority of the ship, fairly simple. There are rows of showers and lockers for storage of toiletries. One of the showers has been left on.

You can see a shower here.

>take shower
You turn on the shower and let it run for a bit to warm up. Once it is warm you jump in and take a quick shower to clean yourself up. You turn off the shower and dry off.

* * *

>e
Equipment room
A cramped storage room with two lockers, one is taller than the other. The hallway is to the west.

>unlock locker #1
(with the Equipment room key)
You unlock Locker #1.

* * *

>unlock locker #2
(with the Equipment room key)
You unlock Locker #2.

>take pilot helmey
You can't see any such thing.

>take pilot helmet
You can't see any such thing.

>open locker #2
You open Locker #2, revealing your flight suit.

>open locker #1
You open Locker #1, revealing your pilot helmet.

>take helmet
Taken.

>take flight suit
Taken.

>put on helmet
You put on your pilot helmet.

>put on flight suit
You put on your flight suit.

    *** Now that you are in full combat uniform and have a full stomach you head to your ship. You climb into the cockpit and strap yourself in. With the green light from mission controll you start the launch sequence. 3, 2, 1. At 1 the ship launches forward and you are compressed to the back of your seat. You quickly move to catch up to the rest of your squad. ***

Would you like to RESTART, RESTORE a saved game, QUIT or UNDO the last command?

* * *

>e
Hanger
One of the smaller hangers in the ship. The floor is littered with empty storage containers and fuel cells. There are 8 seperate areas each assigned to one fighter. All but one of them is empty. The Mess hall entrance is to the west.

You can see Jackson here.

>ask jackson about key
"Sir may I have the equipment room key?" you ask 

 "Alright, here you go corpral." he replies

I beg your pardon?

>w
Mess hall
The main mess hall of the ship. All of the workers seem to be off duty and as a result the whole place seems to be deserted. Not a single scrap of food is in sight. The hanger is to the east.

* * *

>unlock locker #2
(with the Equipment room key)
You unlock Locker #2.

>open locker #2
You open Locker #2, revealing your flight suit.

* * *

>take helmet
Taken.

>take suit
Taken.

>put on helmet
You put on your pilot helmet.

>w
Hallway
A hallway with many different paths and doors. The floor is a shining white synthetic polymer. Your living quarters are to the north. The Mess hall entrance is to the south. The Wash room is to the west and the equipment room is to the east.

>w
Wash room
The public wash room, much like the majority of the ship, fairly simple. There are rows of showers and lockers for storage of toiletries. One of the showers has been left on.

You can see a shower here.

* * *

>take shower
You turn on the shower and let it run for a bit to warm up. Once it is warm you jump in and take a quick shower to clean yourself up. You turn off the shower and dry off.

>put on suit
You put on your flight suit.

    *** Now that you are in full combat uniform and have a full stomach you head to your ship. You climb into the cockpit and strap yourself in. With the green light from mission controll you start the launch sequence. 3, 2, 1. At 1 the ship launches forward and you are compressed to the back of your seat. You quickly move to catch up to the rest of your squad. ***

Would you like to RESTART, RESTORE a saved game, QUIT or UNDO the last command?

* * *

>ask jackson about key
"Sir may I have the equipment room key?" you ask 

 "Alright, here you go corpral." he replies

>i
You are carrying:
  an Equipment room key

>n
You can't go that way.

>w
Mess hall

* * *

>e
Equipment room

>unlock locker
Which do you mean, Locker #1 or Locker #2?

>#1
(with the Equipment room key)
You unlock Locker #1.

>#2
That's not a verb I recognise.

>unlock #2
(with the Equipment room key)
That doesn't seem to fit the lock.

* * *

>e
Hanger
One of the smaller hangers in the ship. The floor is littered with empty storage containers and fuel cells. There are 8 seperate areas each assigned to one fighter. All but one of them is empty. The Mess hall entrance is to the west.

You can see Jackson here.

>ask jackson for key
"Sir may I have the equipment room key?" you ask 

 "Alright, here you go corpral." he replies

>talk to jackson
"Sir!" you say in a loud clear voice. 

"Yes corpral?" he replies sternly.

"Sir, do you have the equipment room key by any chance?" you ask

"As a matter of fact I do corpral. Do you need it for something? He asks 

"Yes sir!" you reply "I need to get my flight gear sir."

"Flight gear?" he questions "what do you need that for corpral?"

"For the mission sir." you reply faintly 

"Did i hear you say mission corpral?" he replies. 

"Yes Sir!" you answer

 "as far as i know there are no upcoming missions. unless you are talking about the mission that went under way 10 minutes ago! he yells"

"Yes sir, that one sir" you respond

"well why didnt you just ask for the key? he questions.

 you decide that it would be best to stop the conversation at this point.

* * *

>e
Hanger
One of the smaller hangers in the ship. The floor is littered with empty storage containers and fuel cells. There are 8 seperate areas each assigned to one fighter. All but one of them is empty. The Mess hall entrance is to the west.

You can see Jackson here.

>talk to Jackson
"Sir!" you say in a loud clear voice. 

"Yes corpral?" he replies sternly.

"Sir, do you have the equipment room key by any chance?" you ask

"As a matter of fact I do corpral. Do you need it for something? He asks 

"Yes sir!" you reply "I need to get my flight gear sir."

"Flight gear?" he questions "what do you need that for corpral?"

"For the mission sir." you reply faintly 

"Did i hear you say mission corpral?" he replies. 

"Yes Sir!" you answer

 "as far as i know there are no upcoming missions. unless you are talking about the mission that went under way 10 minutes ago! he yells

* * *

>e
Hanger
One of the smaller hangers in the ship. The floor is littered with empty storage containers and fuel cells. There are 8 seperate areas each assigned to one fighter. All but one of them is empty. The Mess hall entrance is to the west.

You can see Jackson here.

>talk to jackson
"Sir!" you say in a loud clear voice. 

"Yes corpral?" he replies sternly.

"Sir, do you have the equipment room key by any chance?" you ask

"As a matter of fact I do corpral. Do you need it for something? He asks 

"Yes sir!" you reply "I need to get my flight gear sir."

"Flight gear?" he questions "what do you need that for corpral?"

"For the mission sir." you reply faintly 

"Did i hear you say mission corpral?" he replies. 

"Yes Sir!" you answer

 "as far as i know there are no upcoming missions. unless you are talking about the mission that went under way 10 minutes ago! he yells"

"Yes sir, that one sir" you respond

"well why didnt you just ask for the key? he questions.

 Maybe you should ask him about the key.

>ask jackson about key
"Sir may I have the equipment room key?" you ask 

 "Alright, here you go corpral." he replies

* * *

>ask jackson about the key
There is no reply.

>ask jackson about key
"Sir may I have the equipment room key?" you ask 

 "Alright, here you go corpral." he replies

* * *

>e
Hanger
One of the smaller hangers in the ship. The floor is littered with empty storage containers and fuel cells. There are 8 seperate areas each assigned to one fighter. All but one of them is empty. The Mess hall entrance is to the west.

You can see Jackson here.

>w
Mess hall

* * *

>n
Hallway

>w
Wash room
You can see a shower here.

>take shower
You turn on the shower and let it run for a bit to warm up. Once it is warm you jump in and take a quick shower to clean yourself up.

>x player
You can't see any such thing.

>x me
 clean

>e
Hallway

>s
Mess hall

>s
You can't go that way.

>e
Hanger
You can see Jackson here.

>ask about key
You can't see any such thing.

>ask about equipment room key
You can't see any such thing.

>ask jackson about key
"Sir may I have the equipment room key?" you ask 

 "Alright, here you go corpral." he replies

>n
You can't go that way.

* * *

>e
Equipment room

>unlock locker #
Which do you mean, Locker #1 or Locker #2?

>#1
I didn't understand that sentence.

>unlock locker #1
(with the Equipment room key)
You unlock Locker #1.

* * *

>open locker #1
You open Locker #1, revealing your pilot helmet.

>open locker #2
You open Locker #2, revealing your flight suit.

>take pilot
Taken.

>take flight suit
Taken.

* * *

>put on flight suit
You put on your flight suit.

>x me
 clean

>i
You are carrying:
  your flight suit (being worn)
  your pilot helmet (being worn)
  an Equipment room key

>w
Hallway

>n
Living quarters
You can see Task list here.

>n
You can't go that way.

>n
You can't go that way.

>x bed
The bed that was assigned to you.  Not the most comfortable but better than nothing.

* * *

>e
Hanger
One of the smaller hangers in the ship. The floor is littered with empty storage containers and fuel cells. There are 8 seperate areas each assigned to one fighter. All but one of them is empty. The Mess hall entrance is to the west.

You can see Jackson here.

>x jackson
 Sgt. Jackson, your squad leader, he is fully dressed in his combat uniform and seems to be ready for the mission.

>take equipment room key from jackson
That seems to belong to Jackson.

* * *

>x jackson
 Sgt. Jackson, your squad leader, he is fully dressed in his combat uniform and seems to be ready for the mission.

>x Hanger
You can't see any such thing.

* * *

>s
Mess hall
The main mess hall of the ship. All of the workers seem to be off duty and as a result the whole place seems to be deserted. Not a single scrap of food is in sight. The hanger is to the east and the hallway is to the north.

>n
Hallway
A hallway with many different paths and doors. The floor is a shining white synthetic polymer. Your living quarters are to the north. The Mess hall is to the south. The Wash room is to the west and the equipment room is to the east.

>e
Equipment room
A cramped storage room with two lockers, one is taller than the other. The hallway is to the west.

* * *

>e
You can't go that way.

>w
Hallway
A hallway with many different paths and doors. The floor is a shining white synthetic polymer. Your living quarters are to the north. The Mess hall is to the south. The Wash room is to the west and the equipment room is to the east.

* * *

>e
Equipment room
A cramped storage room with two lockers, one is taller than the other. The hallway is to the west.

>x locker
Which do you mean, Locker #1 or Locker #2?

>x locker #1
A standard issue equipment locker standing at 6 feet tall. There is a worn down pinup poster on the front.

>X locker #2
A smaller equipment locker than the adjacent one. It has the faded logo of a once popular soft drink on the front.

* * *

>s
Mess hall
The main mess hall of the ship. All of the workers seem to be off duty and as a result the whole place seems to be deserted. Not a single scrap of food is in sight. The hanger is to the east and the hallway is to the north.

>s
You can't go that way.

* * *

>e
Hanger
You can see Jackson here.

>x jackson
 Sgt. Jackson, your squad leader, he is fully dressed in his combat uniform and seems to be ready for the mission.

>talk to jackson
"Sir!" you say in a loud clear voice. 

"Yes corpral?" he replies sternly.

"Sir, do you have the equipment room key by any chance?" you ask

"As a matter of fact I do corpral. Do you need it for something? He asks 

"Yes sir!" you reply "I need to get my flight gear sir."

"Flight gear?" he questions "what do you need that for corpral?"

"For the mission sir." you reply faintly 

"Did i hear you say mission corpral?" he replies. 

"Yes Sir!" you answer

 "as far as i know there are no upcoming missions. unless you are talking about the mission that went under way 10 minutes ago! he yells"

"Yes sir, that one sir" you respond

"well why didnt you just ask for the key? he questions.

 you decide that it would be best to stop the conversation at this point.

>ask for kwy
You can't see any such thing.

>ask for key
You can't see any such thing.

>ask jackson for key
You can't see any such thing.

* * *

>s
Hallway
A hallway with many different paths and doors. The floor is a shining white synthetic polymer. Your living quarters are to the north. The Mess hall entrance is to the south. The Wash room is to the west and the equipment room is to the east.

>w
Wash room
The public wash room, much like the majority of the ship, fairly simple. There are rows of showers and boxes for storage of toiletries. One of the showers has been left slightly on.

You can see a shower here.

>e
Hallway
A hallway with many different paths and doors. The floor is a shining white synthetic polymer. Your living quarters are to the north. The Mess hall entrance is to the south. The Wash room is to the west and the equipment room is to the east.

>e
Equipment room

>w
Hallway

>s
Mess hall

>n
Hallway

>s
Mess hall

>e
Hanger

>w
Mess hall

* * *

>e
Hallway
A hallway with many different paths and doors. The floor is a shining white synthetic polymer. Your living quarters are to the north. The Mess hall entrance is to the south. The Wash room is to the west and the equipment room is to the east.

>s
Mess hall
The main mess hall of the ship. All of the workers seem to be off duty and as a result the whole place seems to be deserted. Not a single scrap of food is in sight. The hanger is to the east and the hallway is to the north.

* * *

>e
Hanger
One of the smaller hangers in the ship. The floor is littered with empty storage containers and fuel cells. There are 8 seperate areas each assigned to one fighter. All but one of them is empty. The Mess hall entrance is to the west.

You can see Jackson here.

>w
Mess hall
The main mess hall of the ship. All of the workers seem to be off duty and as a result the whole place seems to be deserted. Not a single scrap of food is in sight. The hanger is to the east and the hallway is to the north.

>n
Hallway
A hallway with many different paths and doors. The floor is a shining white synthetic polymer. Your living quarters are to the north. The Mess hall entrance is to the south. The Wash room is to the west and the equipment room is to the east.

* * *

>w
Wash room
The public wash room, much like the majority of the ship, fairly simple. There are rows of showers and boxes for storage of toiletries. One of the showers has been left slightly on.

You can see a shower here.

>take shower
You turn on the shower and let it run for a bit to warm up. Once it is warm you jump in and take a quick shower to clean yourself up. You turn off the shower and dry off.

>drop shower.
Dropped.

I beg your pardon?

>i
You are carrying nothing.

* * *

>e
Hanger
One of the smaller hangers in the ship. The floor is littered with empty storage containers and fuel cells. There are 8 seperate areas each assigned to one fighter. All but one of them is empty. The Mess hall entrance is to the west.

You can see Jackson here.

>ask jackson about the key
"Sir may I have the equipment room key?" you ask 

 "Alright, here you go corpral." he replies

>w
Mess hall
The main mess hall of the ship. All of the workers seem to be off duty and as a result the whole place seems to be deserted. Not a single scrap of food is in sight. The hanger is to the east and the hallway is to the north.

* * *

>e
Equipment room
A cramped storage room with two lockers, one is taller than the other. The hallway is to the west.

>unlock locker 1
(with the Equipment room key)
You unlock Locker 1.

>unlock locker 2
(with the Equipment room key)
You unlock Locker 2.

>open locker 1
You open Locker 1, revealing your pilot helmet.

>open locker 2
You open Locker 2, revealing your flight suit.

>putput on helmet
That's not a verb I recognise.

>put on suit
(first taking your flight suit)
You put on your flight suit.

>put on helmet
(first taking your pilot helmet)
You put on your pilot helmet.

    *** Now that you are in full combat uniform you head to your ship. You climb into the cockpit and strap yourself in. With the green light from mission controll you start the launch sequence. 3, 2, 1. At 1 the ship launches forward and you are compressed to the back of your seat. You quickly move to catch up to the rest of your squad. ***

Would you like to RESTART, RESTORE a saved game, QUIT or UNDO the last command?

* * *

>w
Wash room
The public wash room, much like the majority of the ship, fairly simple. There are rows of showers and boxes for storage of toiletries. One of the showers has been left slightly on.

You can see a shower here.

>turn on shower
You switch the shower on.

* * *

>w
Wash room
The public wash room, much like the majority of the ship, fairly simple. There are rows of showers and boxes for storage of toiletries. One of the showers has been left slightly on.

You can see a shower here.

>x shoer
You can't see any such thing.

>x shower
One of many showers in a row. This one has been left on.

The shower is currently switched on.

>turn off shower
You switch the shower off.

>turn on shower
You switch the shower on.

>take shower
You turn on the shower and let it run for a bit to warm up. Once it is warm you jump in and take a quick shower to clean yourself up. You turn off the shower and dry off.

>turn off shower
You switch the shower off.

>take shower
You turn on the shower and let it run for a bit to warm up. Once it is warm you jump in and take a quick shower to clean yourself up. You turn off the shower and dry off.

* * *

>w
Wash room
The public wash room, much like the majority of the ship, fairly simple. There are rows of showers and boxes for storage of toiletries. One of the showers has been left slightly on.

You can see a shower here.

>x shower
One of many showers in a row. This one has been left on.

The shower is currently switched on.

>take shower
You turn on the shower and let it run for a bit to warm up. Once it is warm you jump in and take a quick shower to clean yourself up. You turn off the shower and dry off.

>e
Hallway
A hallway with many different paths and doors. The floor is a shining white synthetic polymer. Your living quarters are to the north. The Mess hall is to the south. The Wash room is to the west and the equipment room is to the east.

>e
Equipment room

>x locker #1
A standard issue equipment locker standing at 6 feet tall. There is a worn down pinup poster on the front.

>x room
You can't see any such thing.

>x e
You see nothing unexpected in that direction.

I beg your pardon?

>x
What do you want to examine?

>x equipment room
You can't see any such thing.

* * *

>s
Hallway
A hallway with many different paths and doors. The floor is a shining white synthetic polymer. Your living quarters are to the north. The Mess hall entrance is to the south. The Wash room is to the west and the equipment room is to the east.

>x hall way
You can't see any such thing.

* * *

You wake up from your nap and slowly get out of bed. You look around your room and out of the corner of your eye you see the time. You are 10 minutes late for the mission launch! You scramble to get dressed and get going.

Fighter Pilot 
An Interactive Fiction by Jalen Toyama
Release 1 / Serial number 190304 / Inform 7 build 6M62 (I6/v6.33 lib 6/12N) SD

Living quarters
A somewhat small room with a bed and a dresser. Nothing too fancy, but good enough to live in. The exit to the Hallway is to the south.

You can see Task list here.

>take bed
That's hardly portable.

>take task list
Taken.

>x task list
The messy writing reads: Dont forget! get ready, get in the longsword, launch.

* * *

You wake up from your nap and slowly get out of bed. You look around your room and out of the corner of your eye you see the time. You are 10 minutes late for the mission launch! You scramble to get dressed and get going.

Fighter Pilot 
An Interactive Fiction by Jalen Toyama
Release 1 / Serial number 190304 / Inform 7 build 6M62 (I6/v6.33 lib 6/12N) SD

Living quarters
A somewhat small room with a bed and a dresser. Nothing too fancy, but good enough to live in. The exit to the Hallway is to the south.

You can see Task list here.

>take task list
Taken.

>take bed
Taken.

>drop bed
Dropped.

* * *

>take task list
Taken.

>x task list
The messy writing reads: Dont forget! get clean, get dressed and GO!

>s
Hallway
A hallway with many different paths and doors. The floor is a shining white synthetic polymer. Your living quarters are to the north. The Mess hall entrance is to the south. The Wash room is to the west and the equipment room is to the east.

>w
Wash room
The public wash room, much like the majority of the ship, fairly simple. There are rows of showers and lockers for storage of toiletries. One of the showers has been left on.

You can see a shower here.

* * *

>take shower
You turn on the shower and let it run for a bit to warm up. Once it is warm you jump in and take a quick shower to clean yourself up. You turn off the shower and dry off.

>use shower
That's not a verb I recognise.

>e
Hallway
A hallway with many different paths and doors. The floor is a shining white synthetic polymer. Your living quarters are to the north. The Mess hall entrance is to the south. The Wash room is to the west and the equipment room is to the east.

* * *

>x locker
Which do you mean, Locker #1 or Locker #2?

>open locker
Which do you mean, Locker #1 or Locker #2?

>open locker #1
It seems to be locked.

>unlock locker #1
(with Task list)
That doesn't seem to fit the lock.

>w
Hallway
A hallway with many different paths and doors. The floor is a shining white synthetic polymer. Your living quarters are to the north. The Mess hall entrance is to the south. The Wash room is to the west and the equipment room is to the east.

>s
Mess hall
The main mess hall of the ship. All of the workers seem to be off duty and as a result the whole place seems to be deserted. Not a single scrap of food is in sight. The hanger is to the east.

* * *

>e
Hanger
One of the smaller hangers in the ship. The floor is littered with empty storage containers and fuel cells. There are 8 seperate areas each assigned to one fighter. All but one of them is empty. The Mess hall entrance is to the west.

You can see Jackson here.

>talk to jackson
"Sir!" you say in a loud clear voice. 

"Yes corpral?" he replies sternly.

"Sir, do you have the equipment room key by any chance?" you ask

"As a matter of fact I do corpral. Do you need it for something? He asks 

"Yes sir!" you reply "I need to get my flight gear sir."

"Flight gear?" he questions "what do you need that for corpral?"

"For the mission sir." you reply faintly 

"Did i hear you say mission corpral?" he replies. 

"Yes Sir!" you answer

 "as far as i know there are no upcoming missions. unless you are talking about the mission that went under way 10 minutes ago! he yells"

"Yes sir, that one sir" you respond

"well why didnt you just ask for the key? he questions.

 you decide that it would be best to stop the conversation at this point.

>ask jackson about equipment room key
"Sir may I have the equipment room key?" you ask 

 "Alright, here you go corpral." he replies

>i
You are carrying:
  an Equipment room key
  Task list

>s
You can't go that way.

>e
You can't go that way.

>w
Mess hall
The main mess hall of the ship. All of the workers seem to be off duty and as a result the whole place seems to be deserted. Not a single scrap of food is in sight. The hanger is to the east.

* * *

>e
Equipment room
A cramped storage room with two lockers, one is taller than the other. The hallway is to the west.

>unlock locker #1
What do you want to unlock Locker #1 with?

>unlock Locker #2
What do you want to unlock Locker #2 with?

>unlock with equipment room key
You can't see any such thing.

>i
You are carrying:
  an Equipment room key
  Task list

* * *

You wake up from your nap and slowly get out of bed. You look around your room and out of the corner of your eye you see the time. You are 10 minutes late for the mission launch! You scramble to get dressed and get going.

Fighter Pilot 
An Interactive Fiction by Jalen Toyama
Release 1 / Serial number 190304 / Inform 7 build 6M62 (I6/v6.33 lib 6/12N) SD

Living quarters
A somewhat small room with a bed and a dresser. Nothing too fancy, but good enough to live in. The exit to the Hallway is to the south.

You can see Task list here.

>x bed
The bed that was assigned to you.  Not the most comfortable but better than nothing

* * *

You wake up from your nap and slowly get out of bed. You look around your room and out of the corner of your eye you see the time. You are 10 minutes late for the mission launch! You scramble to get dressed and get going.

Fighter Pilot 
An Interactive Fiction by Jalen Toyama
Release 1 / Serial number 190304 / Inform 7 build 6M62 (I6/v6.33 lib 6/12N) SD

Living quarters
A somewhat small room with a bed and a dresser. Nothing too fancy, but good enough to live in. The exit to the Hallway is to the south.

You can see Task list here.

>x dresser
A plain white military dresser filled with nothing but clothes.

>open dressre
You can't see any such thing.

>open dresser
It isn't something you can open.

* * *

You wake up from your nap and slowly get out of bed. You look around your room and out of the corner of your eye you see the time. You are 10 minutes late for the mission launch! You scramble to get dressed and get going.

Fighter Pilot 
An Interactive Fiction by Jalen Toyama
Release 1 / Serial number 190304 / Inform 7 build 6M62 (I6/v6.33 lib 6/12N) SD

Living quarters
A somewhat small room with a bed and a dresser. Nothing too fancy, but good enough to live in. The exit to the Hallway is to the south.

You can see Task list here.

>x task list
The messy writing reads: Dont forget! get clean, get flight suit and GO!

>x bed
The bed that was assigned to you. Not the most comfortable but better than nothing.

>x dresser
A plain white military dresser filled with nothing but clothes.

>take all
(Task list)
Taken.

>s
Hallway
A hallway with many different paths and doors. The floor is a shining white synthetic polymer. Your living quarters are to the north. The Mess hall entrance is to the south. The Wash room is to the west and the equipment room is to the east.

>x floor
You can't see any such thing.

>s
Mess hall
The main mess hall of the ship. All of the workers seem to be off duty and as a result the whole place seems to be deserted. Not a single scrap of food is in sight. The hanger is to the east and the hallway is to the north.

* * *

>key?
That's not a verb I recognise.

>can i have the key?
That's not a verb I recognise.

>ask jackson about the key
"Sir may I have the equipment room key?" you ask 

 "Alright, here you go corpral." he replies

>thanks
That's not a verb I recognise.

>w
Mess hall
The main mess hall of the ship. All of the workers seem to be off duty and as a result the whole place seems to be deserted. Not a single scrap of food is in sight. The hanger is to the east and the hallway is to the north.

* * *

>n
Hallway
A hallway with many different paths and doors. The floor is a shining white synthetic polymer. Your living quarters are to the north. The Mess hall entrance is to the south. The Wash room is to the west and the equipment room is to the east.

>x task list
The messy writing reads: Dont forget! get clean, get flight suit and GO!

>n
Living quarters
A somewhat small room with a bed and a dresser. Nothing too fancy, but good enough to live in. The exit to the Hallway is to the south.

>s
Hallway
A hallway with many different paths and doors. The floor is a shining white synthetic polymer. Your living quarters are to the north. The Mess hall entrance is to the south. The Wash room is to the west and the equipment room is to the east.

* * *

>w
Wash room
The public wash room, much like the majority of the ship, fairly simple. There are rows of showers and boxes for storage of toiletries. One of the showers has been left slightly on.

You can see a shower here.

>shower
That's not a verb I recognise.

>take a shower
You turn on the shower and let it run for a bit to warm up. Once it is warm you jump in and take a quick shower to clean yourself up. You turn off the shower and dry off.

>x task list
The messy writing reads: Dont forget! get clean, get flight suit and GO!

>e
Hallway
A hallway with many different paths and doors. The floor is a shining white synthetic polymer. Your living quarters are to the north. The Mess hall entrance is to the south. The Wash room is to the west and the equipment room is to the east.

* * *

>e
Equipment room
A cramped storage room with two lockers, one is taller than the other. The hallway is to the west.

>take all
There are none at all available!

I beg your pardon?

>open locker
Which do you mean, Locker #1 or Locker #2?

>locker 1
Which do you mean, Locker #1 or Locker #2?

>locker #1
I only understood you as far as wanting to open Locker #1.

>open locker #1
It seems to be locked.

>unlock locker #1 with key
You unlock Locker #1.

* * *

>take
(your pilot helmet)
Taken.

>open locker #2
It seems to be locked.

>take locker #2
That's hardly portable.

>unlock locker #2 with key and open it and take all
You can't use multiple objects with that verb.

>unlock locker #2 with key and open it
You can't use multiple objects with that verb.

>unlock locker #2 with key
You unlock Locker #2.

* * *

>open locker #2
You open Locker #2, revealing your flight suit.

>take all
your flight suit: Taken.

>wear suit
You put on your flight suit.

>wear helment
You can't see any such thing.

>oops put on helmet
"Oops" can only correct a single word.

>put on helmet
You put on your pilot helmet.

    *** Now that you are in full combat uniform you head to your ship. You climb into the cockpit and strap yourself in. With the green light from mission controll you start the launch sequence. 3, 2, 1. At 1 the ship launches forward and you are compressed to the back of your seat. You quickly move to catch up to the rest of your squad. ***

Would you like to RESTART, RESTORE a saved game, QUIT or UNDO the last command?